R 1000 1000
NO ./pictures/colorstone.xpm
SO ./pictures/bluestone.xpm
WE ./pictures/greystone.xpm
EA ./pictures/mossy.xpm
S ./pictures/barrel.xpm
F 10,255,1
C 0, 20,  200
        1111111111111111111111111
        1000000000110000002000001
        1011000001110000002200001
        1001000000000000020000001
111111111011000001110000000000001
100000000011000001110111111011111
11110111111111011100000010001
11110111111111011101010010201
11000000110101011100000010201
10002000000000001100000010011
10000000000000001101010010001
11000001110101011111011110W0111
11110111 1110101 101111010001
11111111 1111111 111111111111