R 600 600
F 10,255  ,0
NO ./pictures/colorstone.xpm

WE ./pictures/greystone.xpm

EA ./pictures/mossy.xpm


C 0, 20,  200

S ./pictures/barrel.xpm

SO          ./pictures/bluestone.xpm

        1111111111111111111111111
        1000000000110000002000001
        1011000001110000002200001
        1001000000000000020000001
        1111111111111111111111111

111111111111111111111111111111111
111111111011000001110000000000001
100000000011000001110111111011111
11110111111111011100000010001
1111011111111101110101001020111
1100000011010101110000010201
10002000000000001100000010011
10000000000000001101010010001
11000001110101011111011110N0111
11110111 1110101 101111010001
11111111 1111111 111111111111