
F   220  ,  100 ,0


WE ./pictures/a.xpm
NO   ./pictures/a.xpm

SO   ./pictures/a.xpm



EA ./pictures/a.xpm
R 1920 1080

S  ./pictures/a.xpm




C 225,30,  0


        1111111111111111111111111
        10111 1W11
        1111111111